1111111111111100000000000000111110011111111111111111111111111111
1001100100111111000000000000001000011111111111111111111001100111
0011001001111111110000000000000011111111111111111111111100110011
1111111111111111111100000000000000111111111111111111111111111111
1111111111001111111111000000000000001111111111111111111111111100
1111111110011111111111110000000000000011111111111111111111111001
1111111111111111111111111100000000000000111111111111111111111111
1111111111111111111111111111000000000000001111111111111111111100
1111111111111111111111111100110000000000000011111111111111111001
1111111111111111111111111110011100000000000000111111111111111111
1111111111111111111111111111111100000000000000111111111111110000
1111111111111111111111111110010000000000000011111111111111110000
0000111111111111111111111111000000000000001111111111111111111111
0000111111111111111111111100000000000000111111111111111111111111
1111111111111111111111111100000000000000111111111111111111111111
1111111111111111111111111111000000000000001111111111111111111111
1111111111111111111111111111110000000000000011111111111111111111
1111111111111111111111111111111100000000000000111111111111111111
1111111111111111111111111111111111000000000000001111111111111111
1111111111111111111111111111111111000000000000001111111111111111
1111111111111111111111111111111100000000000000111111111111111111
1111111111111111111111111111110000000000000011111111111111111111
1100111111111111111111111111111111111111111111111111111111111111
0010011111111111111111111111111111111111111111111111111111111111
0000001111111111111111110000000000000000000011111111111111111111
0000001111111111111111000000000000000000000000111111111111111111
0000000011111111111100000000000000000000000000001111111111111111
0000000000111111110000000000000000000000000000000011111111111111
0000000000001111000000000000000000000000000000000000111111111111
0000000000001000000000000000000000000000000000000000001111111111
1100000000001000000000000000000000000000000000000000001011110011
0011000000001000000000000000000000000000000000000000001000100001
1000010000001000000000000000000000000000000000000000001000001111
1111111100001000000000000000000000000000000000000000001000000011
1111111111001000000000000000000000000000000000000000001000000000
1111111111111000000000000000000000000000000000000000001000000000
1111111111111100000000000000000000000000000000000000001000000000
1111111111111111000000000000000000000000000000000000111100000000
1111111111111111110000000000000000000000000000000011110011000000
1111111111111111111100000000000000000000000000001111111010010000
1111111111111111111111000000000000000000000000111111111111111100
1111111111111111111111110000000000000000000011111111111111111111
1111111111111111111111111100000000000000001111111111111111111111
1111111111111111111111111100000000000000111111111111111111111111
1111111111111111111111111111111111111111111111111111111111111111
1111111111111111111111111111111111111111111111111111111111111111
1111111111111111111100000000000000111111111111111111111111111111
1111111111111111110000000000000011111111111111111111111111111111
1111111111111111110000000000000011111111111111111111111111111111
1111111111111111111100000000000000111111111111111111111111111111
1111111111111111111111000000000000001111111111111111111111111111
1111111111111111111111110000000000000011111111111111111111111111
1111111111111111111111111100000000000000111111111111111111111111
1111111111111111111111111100000000000000111111111111111111110000
1001111111111111111111110000000000000011111111111111111111110000
1111111111111111111111000000000000001100111111111111111111111111
0011111111111111111100000000000000111001111111111111111111111111
0011111111111111111100000000000000110011111111111111111111111100
1111111111111111111111000000000000001111111111111111111111111001
0011111111111111111111110000000000000011111111111111111111111111
1100111111111111111111110000000000000000111111111111111111111100
1110011001000011111111111100000000000000001111111111110011001001
0000010011000011111111111110010000000000000011111111100110000000
0000000000000000000000000000000000000000000000000000000000000000